levelstart
24 276
1008 254
90 224 29
144 224 29
184 224 29
174 268 29
412 256 29
142 382 29
616 256 28
420 376 29
712 276 28
786 244 28
846 244 28
990 218 28
928 398 28
854 276 28
602 376 28

0, 0, 0, 0, 0, 0, 0, 0, 0, 0, 0, 0, 0, 0, 0, 0, 0, 0, 0, 0, 0, 0, 0, 0, 0, 0, 0, 0, 0, 0, 0, 0, 0, 0, 0, 0, 0, 0, 0, 0, 0, 0, 0, 0, 0, 0, 0, 0, 0, 0, 0, 0, 0, 0, 0, 0, 0, 0, 0, 0, 0, 0, 0, 0
0, 0, 0, 0, 0, 0, 0, 0, 0, 0, 0, 0, 0, 0, 0, 0, 0, 0, 0, 0, 0, 0, 0, 0, 0, 0, 0, 0, 0, 0, 0, 0, 0, 0, 0, 0, 0, 0, 0, 0, 0, 0, 0, 0, 0, 0, 0, 0, 0, 0, 0, 0, 0, 0, 0, 0, 0, 0, 0, 0, 0, 0, 0, 0
0, 0, 0, 0, 0, 0, 0, 0, 0, 0, 0, 0, 0, 0, 0, 0, 0, 0, 0, 0, 0, 0, 0, 0, 0, 0, 0, 0, 0, 0, 0, 0, 0, 0, 0, 0, 0, 0, 0, 0, 0, 0, 0, 0, 0, 0, 0, 0, 0, 0, 0, 0, 0, 0, 0, 0, 0, 0, 0, 0, 0, 0, 0, 0
0, 0, 0, 0, 0, 0, 0, 0, 0, 0, 0, 0, 0, 0, 0, 0, 0, 0, 0, 0, 0, 0, 0, 0, 0, 0, 0, 0, 0, 0, 0, 0, 0, 0, 0, 0, 0, 0, 0, 0, 0, 0, 0, 0, 0, 0, 0, 0, 0, 0, 0, 0, 0, 0, 0, 0, 0, 0, 0, 0, 0, 0, 0, 0
31, 31, 31, 31, 31, 31, 31, 31, 31, 31, 31, 31, 31, 31, 29, 0, 0, 0, 0, 0, 0, 0, 0, 0, 0, 0, 0, 0, 0, 0, 0, 0, 0, 0, 0, 0, 0, 0, 0, 0, 0, 0, 0, 0, 0, 0, 0, 23, 31, 31, 31, 31, 31, 31, 31, 31, 31, 31, 31, 31, 31, 31, 31, 31
32, 28, 28, 28, 32, 28, 32, 32, 32, 28, 32, 32, 28, 32, 30, 0, 0, 0, 0, 0, 0, 0, 0, 0, 0, 0, 0, 0, 0, 0, 0, 0, 0, 0, 0, 0, 0, 0, 0, 0, 0, 0, 0, 0, 0, 0, 0, 24, 32, 28, 28, 28, 28, 32, 28, 28, 28, 32, 28, 28, 32, 32, 28, 32
30, 0, 0, 0, 22, 0, 24, 32, 30, 0, 24, 30, 0, 24, 30, 0, 0, 0, 0, 0, 0, 0, 0, 0, 0, 0, 0, 0, 0, 0, 0, 0, 0, 0, 0, 0, 0, 0, 0, 0, 0, 0, 0, 0, 0, 0, 0, 24, 30, 0, 0, 0, 0, 22, 0, 0, 0, 22, 0, 0, 20, 30, 0, 24
30, 0, 21, 0, 22, 0, 24, 32, 30, 0, 24, 30, 0, 24, 30, 0, 0, 0, 0, 0, 0, 0, 0, 0, 0, 0, 0, 0, 0, 0, 0, 0, 0, 0, 0, 0, 0, 0, 0, 0, 0, 0, 0, 0, 0, 0, 0, 24, 30, 0, 23, 31, 31, 30, 0, 17, 0, 22, 0, 21, 0, 22, 0, 24
30, 0, 22, 0, 22, 0, 24, 32, 30, 0, 24, 30, 0, 24, 30, 0, 0, 0, 0, 0, 0, 0, 0, 0, 0, 0, 0, 0, 0, 0, 0, 0, 0, 0, 0, 0, 0, 0, 0, 0, 0, 0, 0, 0, 0, 0, 0, 24, 30, 0, 24, 32, 28, 30, 0, 0, 0, 22, 0, 22, 0, 22, 0, 24
30, 0, 18, 0, 22, 0, 20, 28, 30, 0, 20, 26, 0, 24, 30, 0, 0, 0, 0, 0, 0, 0, 0, 0, 0, 0, 0, 0, 0, 0, 0, 0, 0, 0, 0, 0, 0, 0, 0, 0, 0, 0, 0, 0, 0, 0, 0, 24, 30, 0, 20, 26, 0, 22, 0, 0, 19, 30, 0, 22, 0, 18, 0, 24
30, 0, 0, 0, 22, 0, 0, 0, 22, 0, 0, 0, 0, 24, 30, 0, 0, 0, 0, 0, 0, 0, 0, 0, 0, 0, 0, 0, 0, 0, 0, 0, 0, 0, 0, 0, 0, 0, 0, 0, 0, 0, 0, 0, 0, 0, 0, 24, 30, 0, 0, 0, 0, 22, 0, 21, 0, 22, 0, 24, 29, 0, 0, 24
32, 31, 31, 31, 32, 31, 31, 31, 32, 31, 31, 31, 31, 32, 30, 0, 0, 0, 0, 0, 0, 0, 0, 0, 0, 0, 0, 0, 0, 0, 0, 0, 0, 0, 0, 0, 0, 0, 0, 0, 0, 0, 0, 0, 0, 0, 0, 24, 32, 31, 31, 31, 31, 32, 31, 32, 31, 32, 31, 32, 32, 31, 31, 32
32, 28, 28, 28, 28, 28, 28, 28, 28, 28, 28, 28, 28, 28, 26, 0, 0, 0, 0, 0, 0, 0, 0, 0, 0, 0, 0, 0, 0, 0, 0, 0, 0, 0, 0, 0, 0, 0, 0, 0, 0, 0, 0, 0, 0, 0, 0, 24, 32, 32, 32, 32, 32, 32, 32, 32, 32, 32, 32, 32, 28, 28, 28, 32
30, 0, 0, 0, 0, 0, 0, 0, 0, 0, 0, 0, 0, 0, 0, 0, 0, 0, 0, 0, 0, 0, 0, 0, 0, 0, 0, 23, 31, 31, 31, 31, 31, 31, 31, 31, 29, 0, 0, 0, 0, 0, 0, 0, 0, 0, 0, 20, 28, 28, 28, 28, 28, 28, 28, 28, 28, 28, 32, 26, 0, 0, 0, 24
30, 0, 0, 0, 0, 0, 0, 0, 0, 0, 0, 0, 0, 0, 21, 0, 0, 0, 0, 0, 0, 0, 0, 0, 0, 0, 19, 28, 28, 28, 28, 28, 28, 28, 28, 28, 28, 25, 0, 0, 0, 0, 0, 0, 0, 0, 0, 0, 0, 0, 0, 0, 0, 0, 0, 0, 0, 0, 18, 0, 0, 0, 0, 24
30, 0, 0, 0, 19, 27, 27, 27, 27, 27, 27, 27, 27, 27, 26, 0, 0, 0, 0, 0, 0, 0, 0, 0, 0, 0, 0, 0, 0, 0, 0, 0, 0, 0, 0, 0, 0, 0, 0, 0, 0, 0, 0, 0, 0, 0, 0, 21, 0, 0, 0, 0, 0, 0, 0, 0, 0, 0, 0, 0, 0, 19, 27, 28
32, 27, 25, 0, 0, 0, 0, 0, 0, 0, 0, 0, 0, 0, 0, 0, 0, 0, 0, 0, 0, 0, 0, 0, 0, 0, 0, 0, 0, 0, 0, 0, 0, 0, 0, 0, 0, 0, 0, 0, 0, 0, 0, 0, 0, 0, 0, 20, 27, 27, 27, 27, 27, 27, 27, 27, 25, 0, 0, 0, 17, 0, 0, 0
30, 0, 0, 17, 0, 0, 0, 0, 0, 0, 0, 0, 0, 0, 0, 0, 0, 0, 0, 0, 5, 0, 0, 0, 19, 27, 27, 27, 27, 27, 27, 27, 27, 27, 27, 27, 27, 27, 27, 25, 0, 0, 0, 0, 0, 0, 0, 0, 0, 0, 0, 0, 0, 0, 0, 0, 0, 0, 17, 0, 0, 0, 0, 0
30, 0, 0, 0, 0, 23, 31, 31, 31, 31, 31, 31, 31, 31, 31, 31, 31, 15, 15, 15, 16, 15, 13, 0, 0, 0, 0, 0, 0, 0, 0, 0, 0, 0, 0, 0, 0, 0, 0, 0, 0, 7, 15, 15, 15, 15, 15, 31, 31, 31, 31, 31, 31, 31, 31, 31, 29, 0, 0, 19, 31, 31, 31, 31
30, 0, 0, 19, 27, 28, 28, 28, 28, 28, 28, 28, 32, 32, 32, 32, 32, 16, 16, 16, 16, 16, 16, 13, 0, 0, 0, 0, 0, 0, 0, 0, 0, 0, 0, 0, 0, 0, 0, 0, 7, 16, 16, 16, 16, 16, 16, 32, 32, 32, 32, 32, 32, 32, 32, 32, 32, 29, 0, 0, 20, 32, 32, 32
16, 29, 0, 0, 0, 0, 0, 0, 0, 0, 0, 0, 4, 16, 16, 16, 16, 16, 16, 16, 16, 16, 16, 14, 0, 0, 0, 0, 0, 0, 0, 0, 0, 0, 0, 0, 0, 0, 0, 0, 8, 16, 16, 16, 16, 16, 16, 16, 32, 32, 32, 32, 32, 32, 32, 32, 32, 32, 29, 0, 0, 20, 28, 32
16, 32, 29, 0, 0, 0, 23, 31, 31, 31, 29, 0, 0, 4, 16, 16, 16, 16, 16, 16, 16, 16, 16, 14, 0, 0, 0, 0, 0, 0, 0, 0, 0, 0, 0, 0, 0, 0, 0, 0, 8, 16, 16, 16, 16, 16, 16, 16, 32, 32, 32, 32, 32, 32, 32, 32, 32, 32, 32, 29, 0, 0, 0, 24
16, 16, 32, 29, 0, 0, 20, 28, 28, 28, 32, 13, 0, 0, 4, 16, 16, 16, 16, 16, 16, 16, 16, 14, 0, 0, 0, 0, 0, 0, 0, 0, 0, 0, 0, 0, 0, 0, 0, 0, 8, 12, 16, 16, 12, 16, 16, 16, 16, 16, 16, 16, 16, 16, 16, 32, 32, 32, 32, 28, 25, 0, 0, 24
16, 16, 16, 32, 29, 0, 0, 0, 0, 0, 24, 16, 13, 0, 0, 4, 12, 16, 16, 16, 16, 16, 16, 10, 0, 0, 0, 0, 0, 0, 0, 0, 0, 0, 0, 0, 0, 0, 0, 0, 2, 0, 4, 10, 0, 4, 16, 16, 16, 16, 16, 16, 16, 16, 16, 16, 32, 32, 26, 0, 0, 0, 23, 32
16, 16, 16, 16, 32, 29, 0, 0, 0, 0, 24, 16, 16, 13, 0, 0, 0, 4, 16, 12, 12, 12, 10, 0, 0, 0, 0, 0, 0, 0, 0, 0, 0, 0, 0, 0, 0, 0, 0, 0, 0, 0, 0, 0, 0, 0, 4, 12, 12, 12, 12, 12, 12, 12, 12, 12, 12, 10, 0, 0, 7, 15, 32, 32
16, 16, 16, 16, 16, 32, 31, 31, 31, 31, 32, 16, 16, 16, 13, 0, 0, 0, 2, 0, 0, 0, 0, 0, 0, 0, 0, 0, 0, 0, 0, 0, 7, 11, 13, 0, 0, 7, 13, 0, 7, 13, 0, 0, 0, 0, 0, 0, 0, 0, 0, 0, 0, 0, 0, 0, 0, 0, 0, 7, 16, 16, 32, 32
16, 16, 16, 16, 16, 16, 16, 16, 16, 16, 16, 16, 16, 16, 16, 13, 0, 0, 0, 0, 0, 7, 15, 15, 15, 15, 15, 13, 0, 7, 15, 15, 14, 0, 8, 15, 15, 16, 16, 15, 16, 16, 13, 0, 0, 0, 0, 7, 13, 0, 0, 0, 0, 7, 15, 15, 15, 15, 15, 16, 16, 16, 32, 32
16, 16, 16, 16, 16, 16, 16, 16, 16, 16, 16, 16, 16, 16, 16, 16, 15, 15, 15, 15, 15, 16, 16, 16, 12, 16, 16, 16, 15, 16, 12, 16, 16, 15, 16, 16, 12, 12, 16, 16, 16, 16, 12, 13, 0, 0, 7, 16, 16, 15, 15, 15, 15, 16, 16, 16, 16, 16, 16, 16, 16, 16, 32, 32
16, 16, 16, 16, 16, 16, 16, 16, 16, 16, 16, 16, 16, 16, 16, 16, 16, 16, 16, 16, 16, 16, 16, 14, 0, 8, 16, 16, 16, 14, 0, 8, 16, 16, 12, 10, 0, 0, 8, 12, 12, 14, 0, 8, 15, 15, 16, 16, 16, 16, 16, 16, 16, 16, 16, 16, 16, 16, 16, 16, 16, 16, 32, 32
12, 16, 16, 16, 12, 16, 16, 16, 16, 16, 16, 16, 16, 16, 12, 16, 16, 16, 16, 16, 16, 16, 12, 12, 11, 12, 16, 16, 16, 16, 15, 12, 12, 10, 0, 0, 0, 7, 10, 0, 0, 4, 11, 12, 12, 12, 12, 16, 16, 16, 16, 16, 16, 16, 16, 16, 16, 16, 16, 16, 16, 16, 32, 32
0, 4, 12, 10, 0, 4, 12, 12, 12, 12, 12, 12, 12, 10, 0, 4, 12, 12, 12, 12, 12, 10, 0, 0, 0, 0, 4, 12, 12, 12, 10, 0, 0, 0, 3, 11, 11, 10, 0, 0, 0, 0, 0, 0, 0, 0, 0, 4, 16, 16, 16, 16, 16, 16, 12, 12, 12, 16, 16, 16, 12, 12, 28, 28
0, 0, 0, 0, 0, 0, 0, 0, 0, 0, 0, 0, 0, 0, 0, 0, 0, 0, 0, 0, 0, 0, 0, 0, 0, 0, 0, 0, 0, 0, 0, 0, 0, 0, 0, 0, 0, 0, 0, 0, 0, 0, 0, 0, 0, 0, 0, 0, 8, 16, 16, 16, 16, 14, 0, 0, 0, 8, 16, 14, 0, 0, 0, 0
