levelstart
30 138
1006 210
394 158 32
420 158 32
442 158 32
468 158 32
494 158 32
520 158 32
548 158 32
572 158 32
598 158 32
624 158 32
250 168 30
304 168 30
106 146 30
704 140 30
750 140 30
956 218 30

16, 16, 16, 16, 16, 16, 16, 16, 14, 0, 0, 0, 0, 0, 0, 0, 0, 0, 0, 0, 0, 0, 0, 0, 0, 0, 0, 0, 0, 0, 0, 0, 0, 0, 0, 0, 0, 0, 0, 0, 0, 0, 0, 0, 0, 0, 0, 0, 0, 0, 0, 0, 0, 0, 0, 0, 0, 0, 8, 16, 16, 16, 16, 16
16, 16, 16, 16, 16, 16, 16, 16, 14, 0, 0, 0, 0, 0, 0, 0, 0, 0, 0, 0, 0, 0, 0, 0, 0, 0, 0, 0, 0, 0, 0, 0, 0, 0, 0, 0, 0, 0, 0, 0, 0, 0, 0, 0, 0, 0, 0, 0, 0, 0, 0, 0, 0, 0, 0, 0, 0, 0, 8, 16, 16, 16, 16, 16
16, 16, 16, 16, 16, 16, 16, 16, 14, 0, 0, 0, 0, 0, 0, 0, 0, 0, 0, 0, 0, 0, 0, 0, 0, 0, 0, 0, 0, 0, 0, 0, 0, 0, 0, 0, 0, 0, 0, 0, 0, 0, 0, 0, 0, 0, 0, 0, 0, 0, 0, 0, 0, 0, 0, 0, 0, 0, 8, 16, 16, 16, 16, 16
16, 16, 16, 16, 16, 16, 16, 16, 14, 0, 0, 0, 0, 0, 0, 0, 0, 0, 0, 0, 0, 0, 0, 0, 0, 0, 0, 0, 0, 0, 0, 0, 0, 0, 0, 0, 0, 0, 0, 0, 0, 0, 0, 0, 0, 0, 0, 0, 0, 0, 0, 0, 0, 0, 0, 0, 0, 0, 8, 16, 16, 16, 16, 16
16, 16, 16, 16, 16, 16, 16, 16, 14, 0, 0, 0, 0, 0, 0, 0, 0, 0, 0, 0, 0, 0, 0, 0, 0, 0, 0, 0, 0, 0, 0, 0, 0, 0, 0, 0, 0, 0, 0, 0, 0, 0, 0, 0, 0, 0, 0, 0, 0, 0, 0, 0, 0, 0, 0, 0, 0, 0, 8, 16, 16, 16, 16, 16
16, 16, 16, 16, 16, 16, 16, 16, 14, 0, 0, 0, 0, 0, 0, 0, 0, 0, 0, 0, 0, 0, 0, 0, 0, 0, 0, 0, 0, 0, 0, 0, 0, 0, 0, 0, 0, 0, 0, 0, 0, 0, 0, 0, 0, 0, 0, 0, 0, 0, 0, 0, 0, 0, 0, 0, 0, 0, 8, 16, 16, 16, 16, 16
16, 16, 16, 16, 16, 16, 16, 16, 14, 0, 0, 0, 0, 0, 0, 0, 0, 0, 0, 0, 0, 0, 0, 0, 0, 0, 0, 0, 0, 0, 0, 0, 0, 0, 0, 0, 0, 0, 0, 0, 0, 0, 0, 0, 0, 0, 0, 0, 0, 0, 0, 0, 0, 0, 0, 0, 0, 0, 8, 16, 16, 16, 16, 16
12, 12, 12, 12, 12, 12, 12, 12, 10, 0, 0, 0, 0, 0, 0, 0, 0, 0, 0, 0, 0, 0, 0, 0, 0, 0, 0, 0, 0, 0, 0, 0, 0, 0, 0, 0, 0, 0, 0, 0, 0, 0, 0, 0, 0, 0, 0, 0, 0, 0, 0, 0, 0, 0, 0, 0, 0, 0, 8, 16, 16, 16, 16, 16
0, 0, 0, 0, 0, 0, 0, 0, 0, 0, 0, 0, 0, 0, 0, 0, 0, 0, 0, 0, 0, 0, 0, 0, 0, 0, 0, 0, 0, 0, 0, 0, 0, 0, 0, 0, 0, 0, 0, 0, 0, 0, 0, 0, 0, 0, 0, 0, 0, 0, 0, 0, 0, 0, 0, 0, 0, 0, 8, 16, 16, 16, 16, 16
0, 0, 0, 0, 0, 0, 0, 0, 0, 0, 0, 0, 0, 0, 0, 0, 0, 0, 0, 0, 0, 0, 0, 0, 0, 0, 0, 0, 0, 0, 0, 0, 0, 0, 0, 0, 0, 0, 0, 0, 0, 0, 0, 0, 0, 0, 0, 0, 0, 0, 0, 0, 0, 0, 0, 0, 0, 0, 8, 16, 16, 16, 16, 16
15, 15, 15, 15, 15, 15, 15, 15, 13, 0, 0, 0, 0, 0, 0, 0, 0, 0, 0, 0, 0, 0, 0, 0, 0, 0, 0, 0, 0, 0, 0, 0, 0, 0, 0, 0, 0, 0, 0, 0, 0, 0, 7, 15, 15, 15, 15, 15, 15, 13, 0, 0, 0, 0, 0, 0, 0, 0, 8, 16, 16, 16, 16, 16
16, 16, 16, 16, 16, 16, 16, 16, 14, 0, 0, 0, 0, 0, 0, 0, 0, 0, 0, 0, 0, 0, 0, 0, 19, 27, 27, 27, 27, 31, 31, 27, 27, 27, 27, 27, 27, 27, 27, 25, 0, 0, 8, 16, 16, 16, 16, 16, 16, 14, 0, 0, 0, 0, 0, 0, 0, 0, 8, 16, 16, 16, 16, 16
16, 16, 16, 16, 16, 16, 16, 16, 14, 0, 0, 0, 0, 7, 15, 15, 15, 15, 15, 15, 15, 13, 0, 0, 0, 0, 0, 0, 0, 24, 30, 0, 0, 0, 0, 0, 0, 0, 0, 0, 0, 0, 8, 16, 16, 16, 16, 16, 16, 14, 0, 0, 0, 0, 0, 0, 0, 0, 4, 12, 12, 12, 12, 12
16, 16, 16, 16, 16, 16, 16, 16, 14, 0, 0, 0, 0, 8, 16, 16, 16, 16, 16, 16, 16, 14, 0, 0, 0, 0, 0, 0, 0, 24, 30, 0, 0, 0, 0, 0, 0, 0, 0, 0, 0, 0, 8, 16, 16, 16, 16, 16, 16, 14, 0, 0, 0, 0, 0, 0, 0, 0, 0, 0, 0, 0, 0, 0
16, 16, 16, 16, 16, 16, 16, 16, 14, 0, 0, 0, 0, 8, 16, 16, 16, 16, 16, 16, 16, 14, 0, 0, 0, 0, 0, 0, 0, 24, 30, 0, 0, 0, 0, 0, 0, 0, 0, 0, 0, 0, 8, 16, 16, 16, 16, 16, 16, 14, 0, 0, 0, 0, 0, 0, 0, 0, 0, 0, 0, 0, 0, 0
16, 16, 16, 16, 16, 16, 16, 16, 14, 0, 0, 0, 0, 8, 16, 16, 16, 16, 16, 16, 16, 14, 0, 0, 0, 0, 0, 0, 0, 24, 30, 0, 0, 0, 0, 0, 0, 0, 0, 0, 0, 0, 8, 16, 16, 16, 16, 16, 16, 14, 0, 0, 0, 0, 0, 0, 0, 0, 7, 15, 15, 15, 15, 15
16, 16, 16, 16, 16, 16, 16, 16, 14, 0, 0, 0, 0, 8, 16, 16, 16, 16, 16, 16, 16, 14, 0, 0, 0, 0, 0, 0, 0, 24, 30, 0, 0, 0, 0, 0, 0, 0, 0, 0, 0, 0, 8, 16, 16, 16, 16, 16, 16, 14, 0, 0, 0, 0, 0, 0, 0, 0, 8, 16, 16, 16, 16, 16
16, 16, 16, 16, 16, 16, 16, 16, 14, 0, 0, 0, 0, 8, 16, 16, 16, 16, 16, 16, 16, 14, 0, 0, 0, 0, 0, 0, 0, 24, 30, 0, 0, 0, 0, 0, 0, 0, 0, 0, 0, 0, 8, 16, 16, 16, 16, 16, 16, 14, 0, 0, 0, 0, 0, 0, 0, 0, 8, 16, 16, 16, 16, 16
16, 16, 16, 16, 16, 16, 16, 16, 14, 0, 0, 0, 0, 8, 16, 16, 16, 16, 16, 16, 16, 14, 0, 0, 0, 0, 0, 0, 0, 24, 30, 0, 0, 0, 0, 0, 0, 0, 0, 0, 0, 0, 8, 16, 16, 16, 16, 16, 16, 14, 0, 0, 0, 0, 0, 0, 0, 0, 8, 16, 16, 16, 16, 16
16, 16, 16, 16, 16, 16, 16, 16, 14, 0, 0, 0, 0, 8, 16, 16, 16, 16, 16, 16, 16, 14, 0, 0, 0, 0, 0, 0, 0, 24, 30, 0, 0, 0, 0, 0, 0, 0, 0, 0, 0, 0, 8, 16, 16, 16, 16, 16, 16, 14, 0, 0, 0, 0, 0, 0, 0, 0, 8, 16, 16, 16, 16, 16
16, 16, 16, 16, 16, 16, 16, 16, 14, 0, 0, 0, 0, 8, 16, 16, 16, 16, 16, 16, 16, 14, 0, 0, 0, 0, 0, 0, 0, 24, 30, 0, 0, 0, 0, 0, 0, 0, 0, 0, 0, 0, 8, 16, 16, 16, 16, 16, 16, 14, 0, 0, 0, 0, 0, 0, 0, 0, 8, 16, 16, 16, 16, 16
16, 16, 16, 16, 16, 16, 16, 16, 14, 0, 0, 0, 0, 8, 16, 16, 16, 16, 16, 16, 16, 14, 0, 0, 0, 0, 0, 0, 0, 24, 30, 0, 0, 0, 0, 0, 0, 0, 0, 0, 0, 0, 8, 16, 16, 16, 16, 16, 16, 14, 0, 0, 0, 0, 0, 0, 0, 0, 8, 16, 16, 16, 16, 16
16, 16, 16, 16, 16, 16, 16, 16, 14, 0, 0, 0, 0, 8, 16, 16, 16, 16, 16, 16, 16, 14, 0, 0, 0, 0, 0, 0, 0, 24, 30, 0, 0, 0, 0, 0, 0, 0, 0, 0, 0, 0, 8, 16, 16, 16, 16, 16, 16, 14, 0, 0, 0, 0, 0, 0, 0, 0, 8, 16, 16, 16, 16, 16
16, 16, 16, 16, 16, 16, 16, 16, 14, 0, 0, 0, 0, 8, 16, 16, 16, 16, 16, 16, 16, 14, 0, 0, 0, 0, 0, 0, 0, 24, 30, 0, 0, 0, 0, 0, 0, 0, 0, 0, 0, 0, 8, 16, 16, 16, 16, 16, 16, 14, 0, 0, 0, 0, 0, 0, 0, 0, 8, 16, 16, 16, 16, 16
16, 16, 16, 16, 16, 16, 16, 16, 14, 0, 0, 0, 0, 8, 16, 16, 16, 16, 16, 16, 16, 14, 0, 0, 0, 0, 0, 0, 0, 24, 30, 0, 0, 0, 0, 0, 0, 0, 0, 0, 0, 0, 8, 16, 16, 16, 16, 16, 16, 14, 0, 0, 0, 0, 0, 0, 0, 0, 8, 16, 16, 16, 16, 16
16, 16, 16, 16, 16, 16, 16, 16, 14, 0, 0, 0, 0, 8, 16, 16, 16, 16, 16, 16, 16, 14, 0, 0, 0, 0, 0, 0, 0, 24, 30, 0, 0, 0, 0, 0, 0, 0, 0, 0, 0, 0, 8, 16, 16, 16, 16, 16, 16, 14, 0, 0, 0, 0, 0, 0, 0, 0, 8, 16, 16, 16, 16, 16
16, 16, 16, 16, 16, 16, 16, 16, 14, 0, 0, 0, 0, 8, 16, 16, 16, 16, 16, 16, 16, 14, 0, 0, 0, 0, 0, 0, 0, 24, 30, 0, 0, 0, 0, 0, 0, 0, 0, 0, 0, 0, 8, 16, 16, 16, 16, 16, 16, 14, 0, 0, 0, 0, 0, 0, 0, 0, 8, 16, 16, 16, 16, 16
16, 16, 16, 16, 16, 16, 16, 16, 14, 0, 0, 0, 0, 8, 16, 16, 16, 16, 16, 16, 16, 14, 0, 0, 0, 0, 0, 0, 0, 24, 30, 0, 0, 0, 0, 0, 0, 0, 0, 0, 0, 0, 8, 16, 16, 16, 16, 16, 16, 14, 0, 0, 0, 0, 0, 0, 0, 0, 8, 16, 16, 16, 16, 16
16, 16, 16, 16, 16, 16, 16, 16, 14, 0, 0, 0, 0, 8, 16, 16, 16, 16, 16, 16, 16, 14, 0, 0, 0, 0, 0, 0, 0, 24, 30, 0, 0, 0, 0, 0, 0, 0, 0, 0, 0, 0, 8, 16, 16, 16, 16, 16, 16, 14, 0, 0, 0, 0, 0, 0, 0, 0, 8, 16, 16, 16, 16, 16
16, 16, 16, 16, 16, 16, 16, 16, 14, 0, 0, 0, 0, 8, 16, 16, 16, 16, 16, 16, 16, 14, 0, 0, 0, 0, 0, 0, 0, 24, 30, 0, 0, 0, 0, 0, 0, 0, 0, 0, 0, 0, 8, 16, 16, 16, 16, 16, 16, 14, 0, 0, 0, 0, 0, 0, 0, 0, 8, 16, 16, 16, 16, 16
16, 16, 16, 16, 16, 16, 16, 16, 14, 0, 0, 0, 0, 8, 16, 16, 16, 16, 16, 16, 16, 14, 0, 0, 0, 0, 0, 0, 0, 24, 30, 0, 0, 0, 0, 0, 0, 0, 0, 0, 0, 0, 8, 16, 16, 16, 16, 16, 16, 14, 0, 0, 0, 0, 0, 0, 0, 0, 8, 16, 16, 16, 16, 16
16, 16, 16, 16, 16, 16, 16, 16, 14, 0, 0, 0, 0, 8, 16, 16, 16, 16, 16, 16, 16, 14, 0, 0, 0, 0, 0, 0, 0, 24, 30, 0, 0, 0, 0, 0, 0, 0, 0, 0, 0, 0, 8, 16, 16, 16, 16, 16, 16, 14, 0, 0, 0, 0, 0, 0, 0, 0, 8, 16, 16, 16, 16, 16