levelstart
14 132
1000 302
126 152 12
208 126 12
288 146 12
646 110 13
666 110 13
768 110 15
972 110 16
942 110 16
896 110 16
482 306 19
526 306 19
568 306 19
618 306 19
932 306 22
734 306 25
772 306 25

0, 0, 0, 0, 0, 0, 0, 0, 0, 0, 0, 0, 0, 0, 0, 0, 0, 0, 0, 0, 0, 0, 0, 0, 0, 0, 0, 0, 0, 0, 0, 0, 0, 0, 0, 0, 0, 0, 0, 0, 0, 0, 0, 0, 0, 0, 0, 0, 0, 0, 0, 0, 0, 0, 0, 0, 0, 0, 0, 0, 0, 0, 24, 32
0, 0, 0, 0, 0, 0, 0, 0, 0, 0, 0, 0, 0, 0, 0, 0, 0, 0, 0, 0, 0, 0, 0, 0, 0, 0, 0, 0, 0, 0, 0, 0, 0, 0, 0, 0, 0, 0, 0, 0, 0, 0, 0, 0, 0, 0, 0, 0, 0, 0, 0, 0, 0, 0, 0, 0, 0, 0, 0, 0, 0, 0, 24, 32
0, 0, 0, 0, 0, 0, 0, 0, 0, 0, 0, 0, 0, 0, 0, 0, 0, 0, 0, 0, 0, 0, 0, 0, 0, 0, 0, 0, 0, 0, 0, 0, 0, 0, 0, 0, 0, 0, 0, 0, 0, 0, 0, 0, 0, 0, 0, 0, 0, 0, 0, 0, 0, 0, 0, 0, 0, 0, 0, 0, 0, 0, 24, 32
0, 0, 0, 0, 0, 0, 0, 0, 0, 0, 0, 0, 0, 0, 0, 0, 0, 0, 0, 0, 0, 0, 0, 0, 0, 0, 0, 0, 0, 0, 0, 0, 0, 0, 0, 0, 0, 0, 0, 0, 0, 0, 0, 0, 0, 0, 0, 0, 0, 0, 0, 0, 0, 0, 0, 0, 0, 0, 0, 0, 0, 0, 24, 32
0, 0, 0, 0, 0, 0, 0, 0, 0, 0, 0, 0, 0, 0, 0, 0, 0, 0, 0, 0, 0, 0, 0, 0, 0, 0, 0, 0, 0, 0, 0, 0, 0, 0, 0, 0, 0, 0, 0, 0, 0, 0, 0, 0, 0, 0, 0, 0, 0, 0, 0, 0, 0, 0, 0, 0, 0, 0, 0, 0, 0, 0, 24, 32
0, 0, 0, 0, 0, 0, 0, 0, 0, 0, 0, 0, 0, 0, 0, 0, 0, 0, 0, 0, 0, 0, 0, 0, 0, 0, 0, 0, 0, 0, 0, 0, 0, 0, 0, 0, 0, 0, 0, 0, 0, 0, 0, 0, 0, 0, 0, 0, 0, 0, 0, 0, 0, 0, 0, 0, 0, 0, 0, 0, 0, 0, 24, 32
0, 0, 0, 0, 0, 0, 0, 0, 0, 0, 0, 0, 0, 0, 0, 0, 0, 0, 0, 0, 0, 0, 0, 0, 0, 0, 0, 0, 0, 0, 0, 0, 0, 0, 0, 0, 23, 29, 0, 0, 0, 0, 0, 0, 0, 0, 0, 0, 0, 0, 0, 0, 0, 0, 0, 0, 0, 0, 0, 0, 0, 0, 24, 32
0, 0, 0, 0, 0, 0, 0, 0, 0, 0, 0, 0, 0, 0, 0, 0, 0, 0, 0, 0, 0, 0, 0, 0, 0, 0, 0, 23, 31, 31, 31, 31, 29, 0, 0, 0, 24, 32, 29, 0, 0, 0, 0, 0, 0, 0, 0, 0, 0, 0, 0, 0, 0, 0, 0, 0, 0, 0, 0, 0, 0, 0, 24, 32
0, 0, 0, 0, 0, 0, 0, 0, 0, 0, 0, 0, 0, 0, 0, 0, 0, 0, 0, 0, 0, 0, 0, 0, 0, 0, 23, 32, 32, 32, 32, 32, 30, 0, 0, 0, 24, 32, 32, 31, 31, 31, 31, 31, 29, 0, 23, 31, 31, 31, 29, 0, 0, 23, 31, 31, 31, 31, 31, 31, 31, 31, 32, 32
0, 0, 0, 0, 0, 0, 0, 0, 0, 0, 0, 0, 23, 29, 0, 0, 0, 0, 0, 0, 0, 0, 0, 0, 0, 23, 32, 32, 32, 28, 28, 32, 30, 0, 0, 0, 24, 32, 28, 28, 28, 28, 28, 32, 30, 0, 24, 32, 28, 32, 30, 0, 0, 24, 32, 28, 32, 32, 28, 32, 32, 28, 32, 32
31, 31, 29, 0, 0, 0, 0, 0, 23, 29, 0, 0, 24, 30, 0, 0, 23, 31, 31, 29, 0, 0, 0, 0, 23, 32, 32, 32, 30, 0, 0, 24, 30, 0, 0, 0, 24, 30, 0, 0, 0, 0, 0, 24, 30, 0, 24, 30, 0, 24, 30, 0, 0, 24, 30, 0, 24, 30, 0, 24, 30, 0, 24, 32
32, 32, 32, 31, 31, 31, 31, 31, 32, 32, 29, 0, 24, 30, 0, 23, 32, 32, 32, 32, 29, 0, 0, 23, 32, 32, 32, 32, 32, 31, 31, 32, 30, 0, 0, 0, 24, 30, 0, 0, 0, 0, 0, 24, 30, 0, 24, 30, 0, 24, 30, 0, 0, 20, 26, 0, 24, 30, 0, 24, 30, 0, 24, 32
32, 32, 32, 32, 32, 32, 32, 32, 32, 32, 32, 31, 32, 32, 31, 32, 32, 32, 32, 32, 32, 31, 31, 32, 28, 32, 32, 32, 32, 32, 32, 32, 30, 0, 0, 0, 24, 30, 0, 0, 0, 0, 0, 24, 30, 0, 24, 30, 0, 24, 30, 0, 0, 0, 0, 0, 24, 30, 0, 24, 30, 0, 24, 32
32, 32, 32, 32, 32, 32, 32, 32, 32, 32, 32, 32, 32, 32, 32, 32, 32, 28, 28, 28, 32, 32, 32, 30, 0, 24, 32, 28, 28, 32, 32, 32, 30, 0, 0, 0, 24, 30, 0, 0, 0, 0, 0, 24, 30, 0, 24, 30, 0, 24, 30, 0, 0, 0, 0, 0, 24, 30, 0, 20, 26, 0, 24, 32
32, 32, 32, 32, 32, 32, 32, 32, 32, 28, 28, 28, 28, 28, 28, 32, 30, 0, 0, 0, 24, 32, 32, 32, 31, 32, 30, 0, 0, 24, 32, 32, 30, 0, 0, 0, 24, 30, 0, 0, 0, 0, 0, 24, 30, 0, 24, 30, 0, 24, 30, 0, 0, 0, 0, 0, 24, 30, 0, 0, 0, 0, 24, 32
28, 32, 32, 32, 32, 32, 32, 32, 30, 0, 0, 0, 0, 0, 0, 24, 32, 31, 31, 31, 32, 32, 28, 28, 28, 28, 28, 31, 31, 28, 28, 32, 30, 0, 0, 0, 24, 30, 0, 0, 0, 0, 0, 24, 30, 0, 24, 30, 0, 24, 30, 0, 0, 0, 0, 0, 20, 26, 0, 0, 0, 0, 24, 32
0, 20, 28, 32, 32, 32, 28, 28, 32, 31, 31, 31, 31, 31, 31, 32, 28, 28, 32, 32, 32, 26, 0, 0, 0, 0, 0, 24, 30, 0, 0, 24, 30, 0, 0, 0, 20, 26, 0, 0, 0, 0, 0, 20, 26, 0, 20, 26, 0, 20, 26, 0, 0, 0, 0, 0, 0, 0, 0, 0, 0, 0, 24, 32
0, 0, 0, 24, 32, 30, 0, 0, 20, 28, 28, 28, 28, 28, 28, 26, 0, 0, 24, 32, 30, 0, 0, 0, 0, 0, 0, 24, 30, 0, 0, 20, 26, 0, 0, 0, 0, 0, 0, 0, 0, 0, 0, 0, 0, 0, 0, 0, 0, 0, 0, 0, 0, 0, 0, 0, 0, 0, 0, 0, 0, 0, 24, 32
0, 0, 0, 24, 32, 30, 0, 0, 0, 0, 0, 0, 0, 0, 0, 0, 0, 0, 24, 32, 30, 0, 0, 0, 0, 0, 0, 24, 30, 0, 0, 0, 0, 0, 0, 0, 0, 0, 0, 0, 0, 0, 0, 0, 0, 0, 0, 0, 0, 0, 0, 0, 0, 0, 0, 0, 0, 0, 0, 0, 0, 0, 20, 28
0, 0, 0, 24, 32, 30, 0, 0, 0, 0, 0, 0, 0, 0, 0, 0, 0, 0, 24, 32, 30, 0, 0, 0, 0, 0, 0, 24, 30, 0, 0, 0, 0, 0, 0, 0, 0, 0, 0, 0, 0, 0, 0, 0, 0, 0, 0, 0, 0, 0, 0, 0, 0, 0, 0, 0, 0, 0, 0, 0, 0, 0, 0, 0
0, 0, 0, 24, 32, 30, 0, 0, 0, 0, 0, 0, 0, 0, 0, 0, 0, 0, 24, 32, 30, 0, 0, 0, 0, 0, 0, 24, 32, 31, 31, 31, 31, 31, 31, 31, 31, 31, 31, 31, 31, 31, 31, 31, 31, 31, 31, 31, 31, 31, 31, 31, 31, 29, 0, 0, 0, 0, 0, 0, 0, 0, 0, 0
0, 0, 0, 24, 32, 30, 0, 0, 0, 0, 0, 0, 0, 0, 0, 0, 0, 0, 24, 32, 30, 0, 0, 0, 0, 0, 0, 20, 32, 32, 32, 32, 28, 28, 28, 28, 28, 28, 28, 32, 32, 32, 32, 32, 32, 32, 28, 28, 32, 32, 32, 32, 32, 32, 31, 31, 31, 31, 31, 31, 31, 31, 31, 31
0, 0, 0, 24, 32, 30, 0, 0, 0, 0, 0, 0, 0, 0, 0, 0, 0, 0, 24, 32, 30, 0, 0, 0, 0, 0, 0, 0, 20, 32, 32, 26, 0, 0, 0, 0, 0, 0, 0, 20, 28, 28, 32, 32, 28, 26, 0, 0, 20, 28, 28, 32, 32, 28, 28, 28, 28, 28, 28, 28, 28, 28, 32, 32
0, 0, 0, 24, 32, 30, 0, 0, 0, 0, 0, 0, 0, 0, 0, 0, 0, 0, 24, 32, 30, 0, 0, 0, 0, 0, 0, 0, 0, 24, 30, 0, 0, 0, 0, 0, 0, 0, 0, 0, 0, 0, 24, 30, 0, 0, 0, 0, 0, 0, 0, 24, 30, 0, 0, 0, 0, 0, 0, 0, 0, 0, 20, 28
0, 0, 0, 24, 32, 30, 0, 0, 0, 0, 0, 0, 0, 0, 0, 0, 0, 0, 24, 32, 30, 0, 0, 0, 0, 0, 0, 0, 0, 24, 30, 0, 0, 0, 0, 0, 0, 0, 0, 0, 0, 0, 24, 30, 0, 0, 0, 0, 0, 0, 0, 24, 30, 0, 0, 0, 0, 0, 0, 0, 0, 0, 0, 0
0, 0, 0, 24, 32, 30, 0, 0, 0, 0, 0, 0, 0, 0, 0, 0, 0, 0, 24, 32, 30, 0, 0, 0, 0, 0, 0, 0, 0, 24, 30, 0, 0, 0, 0, 0, 0, 0, 0, 0, 0, 0, 24, 30, 0, 0, 0, 0, 0, 0, 0, 24, 30, 0, 0, 0, 0, 0, 0, 0, 0, 0, 0, 0
0, 0, 0, 24, 32, 26, 0, 0, 0, 0, 0, 0, 0, 0, 0, 0, 0, 0, 20, 28, 26, 0, 0, 0, 0, 0, 0, 0, 0, 24, 30, 0, 0, 0, 0, 0, 0, 0, 0, 0, 0, 0, 24, 30, 0, 0, 0, 0, 0, 0, 0, 24, 30, 0, 0, 0, 0, 0, 0, 0, 0, 0, 0, 0
0, 0, 0, 20, 26, 0, 0, 0, 0, 0, 0, 0, 0, 0, 0, 0, 0, 0, 0, 0, 0, 0, 0, 0, 0, 0, 0, 0, 0, 24, 30, 0, 0, 0, 0, 0, 0, 0, 0, 0, 0, 0, 24, 30, 0, 0, 0, 0, 0, 0, 0, 24, 30, 0, 0, 0, 0, 0, 0, 0, 0, 0, 0, 0
0, 0, 0, 0, 0, 0, 0, 0, 0, 0, 0, 0, 0, 0, 0, 0, 0, 0, 0, 0, 0, 0, 0, 0, 0, 0, 0, 0, 0, 24, 30, 0, 0, 0, 0, 0, 0, 0, 0, 0, 0, 0, 24, 30, 0, 0, 0, 0, 0, 0, 0, 20, 26, 0, 0, 0, 0, 0, 0, 0, 0, 0, 0, 0
0, 0, 0, 0, 0, 0, 0, 0, 0, 0, 0, 0, 0, 0, 0, 0, 0, 0, 0, 0, 0, 0, 0, 0, 0, 0, 0, 0, 0, 24, 30, 0, 0, 0, 0, 0, 0, 0, 0, 0, 0, 0, 24, 30, 0, 0, 0, 0, 0, 0, 0, 0, 0, 0, 0, 0, 0, 0, 0, 0, 0, 0, 0, 0
0, 0, 0, 0, 0, 0, 0, 0, 0, 0, 0, 0, 0, 0, 0, 0, 0, 0, 0, 0, 0, 0, 0, 0, 0, 0, 0, 0, 0, 20, 26, 0, 0, 0, 0, 0, 0, 0, 0, 0, 0, 0, 20, 26, 0, 0, 0, 0, 0, 0, 0, 0, 0, 0, 0, 0, 0, 0, 0, 0, 0, 0, 0, 0
0, 0, 0, 0, 0, 0, 0, 0, 0, 0, 0, 0, 0, 0, 0, 0, 0, 0, 0, 0, 0, 0, 0, 0, 0, 0, 0, 0, 0, 0, 0, 0, 0, 0, 0, 0, 0, 0, 0, 0, 0, 0, 0, 0, 0, 0, 0, 0, 0, 0, 0, 0, 0, 0, 0, 0, 0, 0, 0, 0, 0, 0, 0, 0
